XXXXXXXXXX
Xo......oX
X.......PX
XXCXXXXCXX
X.C......X
X..o.....X
X.XX.XXXXX
X.....oXXX
X......XXX
XXXXXXXXXX