XXXXXXXXXX
XXP.....XX
XoX.C.XXoX
X..XX..X.X
X..X...X.X
X..X...C.X
X..X.XX..X
X...CC...X
Xo......oX
XXXXXXXXXX