XXXXXXXXXX
Xo......PX
X.X.XX.X.X
X...C....X
X.X.XX.X.X
X....C.C.X
X.X.XX.X.X
X....C...X
XoX.XXoXoX
XXXXXXXXXX