XXXXXXXXXX
XXX....XXX
XX.C....XX
XXP.XXo.XX
XXXXXX..XX
XXXX...XXX
XXXX..XXXX
XXXXCCXXXX
XXXXooXXXX
XXXXXXXXXX