XXXXXXXXXX
XPXXXXX.oX
X..XXX.C.X
X...Xo...X
XX..C...XX
XX..C...XX
X...X....X
X.oXXX.C.X
X.XXXXX.oX
XXXXXXXXXX