XXXXXXXXXX
Xo..PXo..X
X.XX.XX..X
X.XX.C...X
X..X.CX..X
X..X...X.X
X..C.C...X
X..X.X.XXX
XoXX....oX
XXXXXXXXXX