XXXXXXXXXX
XX.o..XXXX
X......XXX
X......XP.
...CCCC.X.
o.........
X.......XX
X.......XX
X..oX..oXX
XXXXXXXXXX
