XXXXXXXXXX
XP.X..X..X
X.C..X...X
X..X..X..X
X...X..C.X
X..X..X..X
X.C..X...X
X..Xo.X..X
Xo..X..o.X
XXXXXXXXXX