..........
...C......
..XX.CXX..
..XX.PXX..
....XX....
...XXXX...
...XooX...
...X..X...
..........
..........